11111
10001
10001
10001
1CEP1
11111