1111111111111111111111
1000000000000000000001
1000000000P00000000001
1000000000100000000001
100000C00000000C000001
1000011100000011100001
1000000000000000000001
1000000000000000000001
1111111111111111111111