111111111111111111111
100000000000011111001
100000000000000000001
100000000000000000001
100000000000000000001
100000000000000000001
10001PEC0000000000001
111111111111111111111