111111111111111111111111
101000000100000000011101
1C0000000100000011100101
100000000000000101011101
100000000P000000E0000001
100C00000000000000000001
1000000C0000000C00000001
111111111111111111111111