1111111111111111111111
10E01111000000111100C1
10C000000000000C000001
1000111110000111110001
1000000000000P0C000001
100C000011100000110001
1000000000000000000001
1111111111111111111111