11111111111
1E000000001
100000000C1
1C00C000001
1P00C0000C1
11111111111