1111111111111111111111
10001111000E0011110001
100P000000000000000001
1000111110000111110001
1000000000000000000001
100C000011100011000001
1000000000P00000000001
1111111111111111111111