11111111111111111111111
1C100000000000000000001
10000000000000000000001
10000000000000000000001
100000000000000000P0001
10000000000000000010001
10000000000000000000001
10000111000000000000001
100000000000000000000E1
11111111111111111111111