1111111111111111111111
10001111000000111100C1
10CP00000000000C000001
1000111110000111110001
100000000000000C000001
100C00001110000A110001
1000000000P0000000E001
1111111111111111111111