1111111111111111111111
10E0111100000011110001
1000111110000000000011
101000000C000000000101
1000000001000P00000011
10C0000C00000001110C01
1000000000000000000001
1111111111111111111111