111111111111111111111111
1P0000000100000000000001
10000000010000000000E001
1000000000000000C0001001
100000000100000000000001
100000000100000111100001
1000000C0000000C00000001
111111111111111111111111