1111111111111111111111111111111111
1C10000000000000000000000000000001
1110000000000000000000000000000001
1000000000000000000000000000000001
100000000000000000P000000000000001
1000000000000000001000000000000001
1000000000000000000000000000000001
1000011100000000000000000001110001
1000000000000000000000000000000001
1000000000000000000000000000000001
1000000000000000000000000000000111
10000000000000000000000000000001E1
1111111111111111111111111111111111